1
5
#####
#r#e#
# # #
#   #
#####