1
5
#####
#   #
# r #
#   #
#####