2
20
####################
#r #          p  pe#
#     #       p  pp#
##   #########p    #
##     d 1  d   ppp#
##   #########     #
#     #######  k   #
#           d      #
# 1   #######   k  #
#     #######      #
#     #######      #
#  b     d    b    #
#     #######      #
#   #########  #####
##p p    d     p ###
## s #########ps####
# p p          p   #
#                  #
#    2        2    #
####################