2
20
#################### 
#r# # # # # # # #e##
# # # # # # # # # ##
# # # # # # # # # ##
# #  D# # # # # # ##
# # # # # # # # # ##
# #k#   # # # # # ##
# # # # # # # # # ##
#  d# # #   # # # ##
# # # # # # # # # ##
# #2# #  K# # # # ##
# # # # # # # # # ##
# ### # # # # # # ##
#    k# # # # # p ##
# # # # # # #   # ##
# # # # # # # # # ##
# # # # # #   # # ##
# # # # # # # # # ##
# # # # # # # # # ##
####################