2
20
####################
# #p#2# # #   ######
# p p2# # # ##     #
po o op        ### #
# # # # ### ### de##
# # # # # #     ####
po o op   ######  ##
# # # # ###    # # #
# # # # # # ##  #  #
po o op   #   #   ##
# # # # # ###  ##  #
# # # # # #      # #
# # # # #     ##  ##
po   op # # #   #  #
# # # # #   ###  # #
# # # # ####      ##
             #  # ##
# # # # # ### # # k#
#r# # # #   # # ####
####################