1
20
# #         #  #   r
    # # ## #  # ## #
 # # # # #  # #  # #
# #  #     ##   #   
   #   # #   # # # #
 #   # ##  # #      
####  # # #  # # # #
 #   #   # # # #  # 
   #  ## # # # # #  
 # # #       #  ### 
#  # ## ## # # # #  
 # #  # ###  #     #
   # #   # #  # # # 
 #  # ###    #  # # 
#  #      ##  ##    
  # ### # #  #  # # 
# #   # # ##  #   ##
   ##    #   #  #   
# ##  # #  #  #  ## 
e   ##    #  #  #   
