2
20
####################
#r   #   #   #    e#
#    b# #k# #  H   #
#  a   #   #   h  s#
### ##### ######D###
#?#  #        # a  #
#  a hH     b # l  #
#    #        #    #
######### #######o##
#C   #    #######  #
#    # l  #        #
#    d    #  #######
#    ######        #
#?   ###########   #
#  ##############  #
#  #   #2   P  #   #
#   #H     1# H #  #
#        #   #h  # #
#    l#   #   #  K #
####################