2
20
####################
####################
########      ######
####    s#### ######
#### ## ##### ######
#### ## ##### ######
#### ## ##### ######
#### ## #     ######
#### ## o o##s #####
#### ##  #r  # #####
#### s##o o  # #####
##### ##  #  # #####
##### ##  #  # #####
#####     #  # #####
##### ###### # #####
##### ####s       ##
#####      ###    ##
####################
####################
####################