2
20
####################
#H   2# ?  ?  #  e #
#h 1  D  s  s #    #
####### K     ###d##
#s     o  o  o   H #
#                h #
#  a  ######  b  k #
#     #l  r#   #####
#     9    #   #1  #
#k    # 8  #      k#
#     ######   C   #
# C            # 1 #
#####        #######
# ? #        #    k#
#   d   2    d     #
#K  #        #     #
##D#####PP######d###
#   #a o  o a#     #
# t #o  l  o #  t  #
####################