2
20
####################
#r #              s#
#     #        # op#
# ##  #        ##d##
#k#                #
#s#                #
#                  #
#                  #
#       #s#        #
# o     #s#        #
#       ###        #
#                  #
#                  #
#                  #
#  ##############  #
#                  #
#  ##############  #
#                  #
#                  #
####################