2
20
####################  
#r#  2# # ##########
#  #d##  # #   p  e#  
# #          #######
#  ### # # #       #  
# # #  #  #   ## ###
#  #  #   #  # #  k#  
#  #  ###  #  #  ###
#  # #     #  #  # #  
#   ######  # ## ### 
#  ##       # ## ###
#    ######      ###
#  ###       #  # ## 
#     ######  #  # # 
#  ####       #  # #
#      ###### ##  ## 
#  ########   ##  ##  
#           ### #  #
# ############   # #
####################