2
20
####################
####################
#######       p#####
####   s#####  #####
###  # p#####  #####
###  #  #####  #####
###p #  #####  p####
###  #p #       ####
###  #  o o##s  ####
###p #   #r  #   p##
###  s##o o  #    ##
####  ##  #  #p   ##
####  ##  #  #    ##
####p     #p #   p##
####  ###### ## ####
####  ####s      p##
####   p    ##p   ##
####p      p########
####################
####################