2
10
##########
#p       #
#     o  #
#        #
#   r s  #
#        #
#  o     #
#     p  #
#       e#
##########