1
20
####################
#r #  #  K  #  CCe #
# l   D     D    C #
#     #     #b   C #
### ################
#b  ################
#  a      ?     h K#
#    #########ohHh #
#hH  # a #  l#ooh  #
# h  d   #k  d #####
#    #  k#  l#     #
#    #a ###  # bbb #
#  #### ### ####   #
#k  ### ### ####   #
#   ###d###d########
#     ?     ?      #
####################
####################
####################
####################