2
20
####################
#r #  b        # k #
#l    #####    #   #
# ###     #    ##p##
# ### #   #  o   H #
#      o######     #
# ####      #      #
# #######  ###  #  #
#       # # ##  #  #
###    ##    #  # H#
#bH   ###   #   #  #
###   a ##     ##  #
#       ### ##     #
#                  #
#  ## H#   #####C  #
#  #2  #   #? #    #
#        C         #
#  ##H##   ####d## #
#  # 1 #   ### t # #
####################