2
20
####################
#####     r    #####
#########  #########
#######    b #######
####   l       #####
##          o   ####
##############    S#
#            P     #
# ? ################
#       a          #
###############  ? #
#           l      #
#  ? ###############
#      l           #
#################H #
#        a         #
# ?  ###############
#      b     H h  e#
################C  #
####################